
  ##      ######
 ##  ########  ####
  ####      #   ###
    $ #######     #
  #               #
 ##################
 #          #   #       #####
 #                         #
 #                         #
 ###########################
 #                         #
 #                         #
 ###########################  
